#S######
#   #  #
#      #
#      E
########
